######
#S  m#
#m## #
# m G#
######